Rank,Country,Country Code,Gold,Silver,Bronze,Total
1,United States,US,40,44,42,126
2,China,CHN,40,27,24,91
7,Great Britain,GBG,14,22,29,65
5,France,FRA,16,26,22,64
4,Australia,AUS,18,19,16,53
3,Japan,JPN,20,12,13,45
9,Italy,ITA,12,13,15,40
6,Netherlands,NED,15,7,12,34
10,Germany,GER,12,13,8,33
8,South Korea,KOR,13,9,10,32
